{
    "mapName": "Initial Vault Map",
    "mapType": "VAULT",
    "mapTerrainData": [
        "########################################",
        "#................###...########...######",
        "########.#######.###..............######",
        "##.............#.###...########...######",
        "##.............#......................##",
        "##......>......#......................##",
        "##.............#.#########..############",
        "##.............#.#########..############",
        "###.############.##....###..##....#....#",
        "###.#.....######.##....###..##....#....#",
        "###.#............##.........##....#....#",
        "###.#.....#####.###....###..##....#....#",
        "###.###.######...##....###..##....#....#",
        "###........###.#.#########..#####...####",
        "##########.###...#####..##..######.#####",
        "#.......##.####.######..##..###.......##",
        "#...>...##.####.######..##.............#",
        "#..........####.........#######.......##",
        "#.......#######.........########.###.###",
        "########################################"
    ],
    "mapFeatures": [
        {
            "featureType": "PORTAL",
            "tileType": "UPSTAIRS"
        }
    ]
}
