Map Name:
---------
Starting Map

Tile Data:
----------
########################################
#................###...########...######
########.#######.###..............######
##.............#.###...########...######
##.............#......................##
##.............#......................##
##.............#.#########..############
##.............#.#########..############
###.############.##....###..##....#....#
###.#.....######.##....###..##....#....#
###.#............##.........##....#....#
###.#.....#####.###....###..##....#....#
###.###.######...##....###..##....#....#
###........###.#.#########..#####...####
##########.###...#####..##..######.#####
#.......##.####.######..##..###.......##
#.......##.####.######..##.............#
#..........####.........#######.......##
#.......#######.........########.###.###
########################################

Features:
---------